111111111111111111111111111111111111111
1CCCCCCCCCCCCCCCCC1E1CCCCCCCCCCCCCCCCC1
1C1111C1111C1111CC1C1CC1111C1111C1111C1
1C1111C1111C1111CC1C1CC1111C1111C1111C1
1C1111C1111C1111CC1C1CC1111C1111C1111C1
1C1111C1111C1111CC1C1CC1111C1111C1111C1
1CCCCCCCCCCCCCCCCCCCCCCCCCCCCCCCCCCCCC1
1CCCCCCCCCCCCCCCCCCCCCCCCCCCCCCCCCCCCC1
1CCCCCCCCCCCCCCCCCCCCCCCCCCCCCCCCCCCCC1
1C1111C1111C1111CC1C1CC1111C1111C1111C1
1C1111C1111C1111CC1C1CC1111C1111C1111C1
1C1111C1111C1111CC1C1CC1111C1111C1111C1
1C1111C1111C1111CC1C1CC1111C1111C1111C1
1CCCCCCCCCCCCCCCCC1P1CCCCCCCCCCCCCCCCC1
111111111111111111111111111111111111111
